NO textures/T1.xpm
SO textures/T2.xpm
WE textures/T3.xpm
EA textures/T4.xpm

F 176,11,105
C 105,176,11

1111111111111111
1000000000000001
1111100100011001
1000000100001001
1001100100001001
1000100100000001
1011100000000001
1010001100111101
1010111000000101
1000000001100101
1000000000100001
1000000N00101111
1000100000100001
1000100000001101
1000101010000001
1111111111111111
