NO textures/portal/T1.xpm
SO textures/portal/T2.xpm
WE textures/portal/T3.xpm
EA textures/portal/T4.xpm

F 176,11,105
C 105,176,11

111111111111111
1000000N0000001
111110010001101
100000010000101
100000000000101
100011101110001
1001   1   1001
101         101
101         101
1001       1011
10001     10001
100001   100111
1000101 1010001
100010010000111
100010000000001
111111111111111
