NO textures/portal/T1.xpm
SO textures/portal/T2.xpm
WE textures/portal/T3.xpm
EA textures/portal/T4.xpm

C 200,200,220
F 100,100,110

111111111111111
100000000000001
111110010001101
100000010000101
10N000000000101
100011101110001
1001   1   1001
101         101
101         101
1001       1011
10001     10001
100001   100111
1000101 1010001
100010010000111
100010000000001
111111111111111
