NO textures/portal/T1.xpm
SO textures/portal/T2.xpm
WE textures/portal/T3.xpm
EA textures/portal/T4.xpm

C 200,200,220
F 100,100,110

1111111111111111111111111111111111
1000000000000000000000000000000001
1000000000000000000000000000000001
1000000000000000000000000000000001
1000000000000111011100000000000001
1000000000001   1   10000000000001
100000000001         1000000000001
100000000001         1000000000001
1000000000001       10000000000001
10000000000001     100000000000001
100000000000001   1000000000000001
1000000000000001 10000000000000001
1000000000000000100000000000000001
1000000000000000000000000000000001
1000000000000000N00000000000000001
1000000000000000000000000000000001
1111111111111111111111111111111111
