NO textures/frutiger_aero/T1.xpm
SO textures/frutiger_aero/T3.xpm
WE textures/frutiger_aero/T2.xpm
EA textures/frutiger_aero/T4.xpm

F 151,219,198
C 83,184,196

1111111111111111111111111111111111111111111
100000000000000000000000000000000000000001
 1000000000000000000000000000000000000001
  10000000000000000000000000000000000001
   100000000000000000000000000000000001
    1000000000000000000000000000000001
     10000000000000000000000000000001
      100000000000000000000000000001
       1000000000000000000000000001
        10000000000000000000000001
         100000000000000000000001
          1000000000000000000001
           10000000000000000001
            100000000000000001
             1000000S00000001
              10000000000001
               100000000001
                1000000001
                 10000001
                  100001
                   1001
                    11
