11111111111111111111111111111111
10000000000000000000000000000001
10101000000000000000000000001001
10000000000000000000000000010101
10101000000000000000000000001001
10000000000000000000000000000001
10000000000000000000000000000001
10000000001100000000000000000001
10000001000100000000000000000001
10000001100100000000000000000001
10000000100000000000000000000001
10000111100111000000000000000001
10001000000000000000000000000001
10000000000000000000000001000001
10000000000000000000000000000001
10000000000000000000000000000001
10001000000000000000000000000001
10001000000000000000000000000001
10001110000000000000000001000001
10000000000000000000000000000001
10000000000000000000000000000001
10000000000000000000001000000001
10000000000000000000010000000001
10000000000000000000000000000001
10000000000000000000000000000001
10000000010000000000000000000001
10000010000000000000100000000001
10000110000000000000000000000001
10000000000000000000000000011001
10010000000000000000000000011001
10000000000000000000000000000001
11111111111111111111111111111111
