NO textures/T1.xpm
SO textures/T2.xpm
WE textures/T3.xpm
EA textures/T4.xpm

F 176,11,105
C 105,176,11

1111111111111111
1001000000000001
101r100000000001
1001000000000001
1000000000000001
1000000000000001
1000000000000001
100000000000r001
10000000W0000001
1000000000000001
1000000000000001
1000000000000001
1000000000000001
1000000000000001
1000000000000001
1111111111111111
